111111111111111111111
101000000000000000011
111000000010001111011
100000111110C01000011
1010001P0C10001000011
1E1000100011111011111
101111100011111010011
10C001100000000010011
111111111111111111111